강호에 병이깁퍼 듁님의 누엇더니 | 강호에 병이 깊어 대숲에 누었더니
관동 팔ᄇᆡᆨ니에 방면을 맛디시니 | 관동 팔백 리에 관찰사를 맡기시니
어와 셩은이야 가디록 망극ᄒᆞ다 | 아아 성은이여 갈수록 망극하다
연츄문 드리ᄃᆞ라 경회남문 ᄇᆞ라보며 | 연추문 달려들어 경회 남문 바라보며
하직고 믈너나니 옥졀이 알ᄑᆡ셧다 | 하직하고 물러나니 옥절이 앞에 섰다
평구역 ᄆᆞᆯ을ᄀᆞ라 흑슈로 도라드니 | 평구역에서 말을 갈아 흑수로 돌아드니
셤강은 어듸메오 티악이 여긔로다 | 섬강은 어디인가 치악이 여기로다
쇼양강 ᄂᆞ린믈이 어드러로 든단말고 | 소양강 내려온 물이 어디로 흘러가나
고신 거국에 ᄇᆡᆨ발도 하도할샤 | 고신 거국에 백발이 많기도 많구나
동ᄌᆔ밤 계오새와 븍관뎡의 올나 ᄒᆞ니 | 동주 밤을 겨우 새고 불관정에 올라가니
삼각산 뎨일봉이 ᄒᆞ마연 뵈리로다 | 삼각산 제일봉이 어찌하면 보일 것 같다
궁왕 대궐터희 오쟉이 지지괴니 | 궁왕 대궐터에 까막까치가 지저귀니
쳔고 흥망을 아ᄂᆞᆫ다 몰ᄋᆞᄂᆞᆫ다 | 천고의 흥망을 아는냐 모르느냐
회양 녜일홈이 마초아 ᄀᆞᄐᆞᆯ시고 | 회양의 옛이름이 마침 같구나
급댱유 풍ᄎᆡ를 고텨아니 볼게이고 | 급장유 풍채를 다시 보지 않을 것인가 
영듕이 무ᄉᆞᄒᆞ고 시졀이 삼월인제 | 영중이 무사하고 시절이 삼월일때
화쳔 시내길히 풍악으로 버더잇다 | 화천 시냇길이 풍악으로 뻗어 있다
ᄒᆡᆼ장을 다ᄯᅥᆯ티고 셕경의 막대디퍼 | 행장을 다 떨치고 돌길에 막대를 짚어
백쳔동 겨ᄐᆡ두고 만폭동 드러가니 | 백천동 곁에 두고 만폭동 들어가니
은ᄀᆞᄐᆞᆫ 무지계 옥ᄀᆞᄐᆞᆫ 룡의 초리 | 은같은 무지게 옥같은 용의 꼬리
섯돌며 ᄲᅮᆷᄂᆞᆫ소ᄅᆡ 십리의 ᄌᆞ자시니 | 섞여 돌며 뿜는 소리 십리에 자자하니
들을제ᄂᆞᆫ 우레러니 보니ᄂᆞᆫ 눈이로다 | 들을때는 우레더니 보니 눈이로다
금강ᄃᆡ ᄆᆡᆫ우층의 션학이 삿기치니 | 금강대 맨 위층에 선학이 새끼치니
츈풍 옥뎍셩의 첫ᄌᆞᆷ을 ᄭᆡ돗던디 | 봄바람 옥피리 소리에 첫잠을 깨었던지
호의현샹이 반공의 소소ᄯᅳ니 | 호의현상이 공중으로 솟으니
셔호 녯 쥬인을 반겨셔 넘노ᄂᆞᆫᄃᆞᆺ | 서호 옛 주인을 반겨서 넘노는 듯
쇼향노 대향노 눈아래 구버보고 | 소향로 대향로 눈 아내 굽어보고
졍양ᄉᆞ 진헐ᄃᆡ 고텨올나 안ᄌᆞᆫ마리 | 정양사 진헐대 다시올라 앉았더니
녀산 진면목이 여긔야 다뵈ᄂᆞ다 | 여산의 진면목이 여기 다보이는구나
어와 조화옹이 헌ᄉᆞ토 헌ᄉᆞᄒᆞᆯ샤 | 아아 조물주가 야단스럽기도 야단스럽구나
ᄂᆞᆯ거든 ᄯᅱ디마나 셧거든 솟디마나 | 날거든 뛰지 말거나 섰거든 솟지말거나
부용을 고잣ᄂᆞᆫ ᄃᆞᆺ ᄇᆡᆨ옥을 믓것ᄂᆞᆫ ᄃᆞᆺ | 연꽃을 꽃아논 듯 백옥을 묶었는 듯 
동명을 박차ᄂᆞᆫ ᄃᆞᆺ 북극을 괴왓ᄂᆞᆫ ᄃᆞᆺ | 동해바다를 박차는 듯 북극을 괴었는 듯
놉흘시고 망고ᄃᆡ 외로올샤 혈망봉이 | 높을시고 망고대 외롭구나 혈망봉아
하ᄂᆞᆯ의 추미러 므ᄉᆞ 일을 ᄉᆞ로리라 | 하늘에 치밀어 무슨 일을 아뢰려고
쳔만겁 디나ᄃᆞ록 구필줄 모ᄅᆞᄂᆞᆫ다 | 천만 겁 지나도록 굽힐 줄 모르는가
어와 너여이고 너ᄀᆞᄐᆞ니 ᄯᅩ잇ᄂᆞᆫ가 | 아아 너로구나 너 같은이 또 있는가
ᄀᆡ심ᄃᆡ 고텨올나 듕향셩 ᄇᆞ라보며 | 개심대 다시올라 중향성 바라보며
만이쳔봉을 녁녁히 혀여ᄒᆞ니 | 만이천봉을 역력히 헤아리니
봉마다 ᄆᆡᆺ쳐잇고 긋마다 서린긔운 | 봉마다 맺혀있고 끝마다 서린 기운
ᄆᆞᆰ거든 조티마나 조커든 ᄆᆞᆰ디마나 | 깨끗하지 말거나 깨끗하거든 맑지 말거나
뎌긔운 흐터내야 인걸을 ᄆᆞᆫᄃᆞᆯ고쟈 | 저 기운 흩어 내어 인걸을 만들고 싶다
형용도 그지업고 톄셰도 하도할샤 | 형용도 없고 체세도 많기도 많다
텬디 삼기실제 ᄌᆞ연이 되연마ᄂᆞᆫ | 천지 생길때 저절로 됐건마는
이제와 보게되니 유정도 유정정ᄒᆞᆯ샤 | 이제와 보게되니 유정도 유정하구나
비로봉 샹샹두의 올라보니 긔뉘신고 | 바로봉 상상두 놀라가본게 누구인가
동산 태산이 어ᄂᆞ야 놉돗던고 | 동산 태산이 어느게 높았던가
노국 조븐 줄도 우리ᄂᆞᆫ 모ᄅᆞ거든 | 노국이 좁은 줄도 우리는 모르거든
넙거나 넙은 텬하 엇ᄯᅵᄒᆞ야 젹닷말고 | 넓고 넓은 천하를 어찌하여 작단 말인가
어와 뎌디위ᄅᆞᆯ 어이ᄒᆞ면 알거이고 | 아아 저 경지를 어찌하면 알것인가
오ᄅᆞ디 못ᄒᆞ거니 ᄂᆞ려가미 고이ᄒᆞᆯ가 | 오르지 못하거니 내려감이 이상할까
원통골 ᄀᆞᄂᆞᆫ길로 ᄉᆞᄌᆞ봉을 ᄎᆞ자가니 | 원동골 좁은 길로 사자봉을 찾아가니
그알ᄑᆡ 너러바회 화룡쇠 되어셰라 | 그 앞에 넓은 바위 화룡소가 되었구나 
천년 노룡이 구ᄇᆡ구ᄇᆡ 서려이셔 | 천년 노룡이 굽이굽이 서려 있어
듀야의 흘녀내여 창ᄒᆡ예 니어시니 |  밤낮으로 흘러내려 창해에 이어지니
풍운을 언제어더 삼일우ᄅᆞᆯ 디련ᄂᆞᆫ다 |  풍운을 언제 얻어 삼일우를 내리려나
음애예 이온플을 다살와 내여ᄉᆞ라 | 그늘진 벼랑의 시든 풀을 다 살려 내려무나
마하연 묘길샹 안문재 너머 디여 | 마하연 묘길상 안문재 넘어 가서
외나모 ᄡᅥ근ᄃᆞ리 블뎡ᄃᆡ 올라ᄒᆞ니 | 외나무 썩은 다리 불정대 오르니
쳔심졀벽을 반공애 셰여 두고 | 천심 절벽을 공중에 세워 두고
은하슈 한구ᄇᆡᄅᆞᆯ 촌촌이 버혀내여 | 은하수 큰 굽이를 촌촌이 베어 내어
실ᄀᆞ티 플텨이셔 뵈ᄀᆞ티 거러시니 | 실같이 풀어서 베같이 걸었으니
도경 열두구ᄇᆡ 내보매ᄂᆞᆫ 여러히라 | 도경 열두 굽이 내 보기는 여럿이라
니뎍션 이제이셔 고텨의논 ᄒᆞ게되면 | 이적선 지금 있어 다시 의논하게 되면
녀산이 여긔도곤 낫단말 못ᄒᆞ려니 | 여산이 여기보다 낫단 말 못 하리라
산듕을 ᄆᆡ양보랴 동ᄒᆡ로 가쟈ᄉᆞ라 | 산중을 매일 바라보냐 동해로 가자구나
남여 완보ᄒᆞ야 산영누의 올나ᄒᆞ니 | 남여 완보하여 산영루에 오르니
졍긔를 ᄯᅥᆯ티니 오ᄉᆡᆨ이 넘노ᄂᆞᆫ ᄃᆞᆺ | 깃발을 휘날리니 오색 빛깔 넘나들며 노니는 듯
고각을 섯부니 ᄒᆡ운이 다 것ᄂᆞᆫ ᄃᆞᆺ | 북을 부니 구름이 다 걷히는 듯
명사긴 니근ᄆᆞᆯ이 ᄎᆔ션을 빗기시러 | 백사장 길에 익숙한 말이 취선을 비스듬히 태우고
바다ᄒᆞᆯ 겻ᄐᆡ두고 ᄒᆡ당화로 드러가니 | 바다를 옆에 끼고 해변의 해당화로 들어가니
ᄇᆡᆨ구야 ᄂᆞ디마라 네버딘줄 엇디아ᄂᆞᆫ | 갈매기야 날지마라 네 벗인 줄 어찌 아느냐
금난굴 도라드러 총셕뎡 올라ᄒᆞ니 | 금란굴 돌아들어 총석정 올라가니
ᄇᆡᆨ옥누 남은기동 다만네히 셔잇고야 | 백옥루 남은기둥 다만넷이 서 있구나
공슈의 셩녕인가 귀부로 다ᄃᆞᄆᆞᆫ가 | 공수의 솜씨인가 귀부로 다듬었나
구ᄐᆞ야 뉵면은 므어슬 샹톳던고 | 구태여 육 면은 무엇을 본떴는가?
고셩을란 뎌만 두고 삼일포ᄅᆞᆯ ᄎᆞ자가니 | 고성은 저만 두고 삼일포를 찾아가니
단셔ᄂᆞᆫ 완연ᄒᆞ되 ᄉᆞ션은 어ᄃᆡ 가니 | 붉은 글씨는 완연한데 사선은 어디 갔나
예 사흘 머믄 후의 어ᄃᆡ 가 ᄯᅩ 머믈고 | 예서 사흘 머문 후에 어디 가 또 머물까
션유담 영냥호 거긔나 가 잇ᄂᆞᆫ가 | 선유담 영랑호 거기나 가 있는가
쳥간뎡 만경ᄃᆡ 몃 고ᄃᆡ 안돗던고 | 청간정 만경대 몇 곳에 앉았던가
니화ᄂᆞᆫ ᄇᆞᆯ셔디고 졉동새 슬피울제 | 배꽃은 벌써 지고 접동새 슬피 울 때
낙산동반으로 의샹ᄃᆡ예 올라 안자 | 낙산 동쪽 언덕으로 의상대에 올라앉아
일츌을 보리라 밤듕만 니러ᄒᆞ니 | 일출을 보려고 밤중에 일어나니
샹운이 집픠ᄂᆞᆫ동 뉵뇽이 바퇴ᄂᆞᆫ동 | 상운이 피어나는 듯 육룡이 받치는 듯 
바다ᄒᆡ ᄯᅥ날제ᄂᆞᆫ 만국이 일위더니 | 바다에서 떠날 때 온 세상이 일렁이더니
텬듕의 티ᄯᅳ니 호발을 혜리로다 | 하늘 가운데에 치뜨니 가는 털을 세리로다
아마도 녈구름 근쳐의 머믈셰라 | 혹시나 뜬구름이 근처에 머물까 두렵구나
시션은 어ᄃᆡ가고 ᄒᆡ타만 나ᄆᆞᆺᄂᆞ니 | 시선은 어디 가고 해타만 남았는가
텬디간 장ᄒᆞᆫ 긔별ᄌᆞ셔히도 ᄒᆞᆯ셔이고 | 천지간에 장한 기별 자세히도 알겠구나
샤양 현산의 텩튝을 므니ᄇᆞᆯ와 | 석양 현산의 철쭉을 계속 밟아
우개지륜이 경포로 ᄂᆞ려가니 | 우개지륜이 경포로 내려가니
십리 빙환을 다리고 고텨다려 | 십 리 빙환을 다리고 다시 다려
댱숑 울흔소개 슬ᄏᆞ장 펴뎌시니 | 큰 소나무 울창한 속에 실컷 펼쳤으니
믈결도 자도잘샤 모래ᄅᆞᆯ 혜리로다 | 물결도 잔잔하여 모래를 셀 수 있다
고쥬 ᄒᆡ람ᄒᆞ야 亭子뎡ᄌᆞ우ᄒᆡ 올나가니 | 배 한 척을 띄어 정자 위에 올라가니
강문교 너믄겨ᄐᆡ 대양이 거긔로다 | 강문교 넘은 곁에 대양이 거기로다
둉용ᄒᆞᆫ댜 이 긔샹 활원ᄒᆞᆫ댜 뎌 경계 | 조용하다 이 기상 활원하다 저 경계
이도곤 ᄀᆞᄌᆞᆫ ᄃᆡ ᄯᅩ어듸 잇닷말고 | 이보다 갖춘 곳 또 어디 있단 말인가
홍장 고ᄉᆞᄅᆞᆯ 헌ᄉᆞ타 ᄒᆞ리로다 | 홍장 고사를 요란하다 하리다
강능 대도호 풍쇽이 됴흘시고 | 강릉 대도호 풍속이 좋을시고
졀효졍문이 골골이 버러시니 | 절효정문이 골골이 벌였으니
비옥가봉이 이제도 잇다 ᄒᆞᆯ다 | 비옥가봉이 이제도 있다 할까
진쥬관 듁셔루 오십쳔 ᄂᆞ린믈이 | 진주관 죽서루 오십천 내린 물이
태ᄇᆡᆨ산 그림재ᄅᆞᆯ 동ᄒᆡ로 다마가니 | 태백산 그림자를 동해로 담아 가니
ᄎᆞᆯ하리 한강의 목멱의 다히고져 | 차라리 한강의 목멱에 닿게 하고 싶다
왕뎡이 휴ᄒᆞᆫᄒᆞ고 풍경이 못슬믜니 | 왕정이 유한하고 풍경이 싫지 않으니
유희도 하도할샤 ᄀᆡᆨ수도 둘듸업다 | 유희가 많기도 많다 | 객수도 둘 곳 없다
션사ᄅᆞᆯ ᄯᅴ워 내여 두우로 향ᄒᆞ살가 | 선사를 띄어 내어 두우로 향할까
션인을 ᄎᆞᄌᆞ려 단혈의 머므살가 | 선인을 찾으러 단혈에 머무를까
텬근을 못내보와 망양뎡의 올은말이 | 하늘 끝을 보지 못해 망양정에 올랐더니
바다밧근 하ᄂᆞᆯ이니 하ᄂᆞᆯ밧근 므서신고 | 바다 밖은 하늘이니 하늘 밖은 무엇인가
ᄀᆞᆺ득 노ᄒᆞᆫ고래 뉘라셔 놀내관ᄃᆡ | 가득 성난 고래 누구라서 놀랬건대
블거니 ᄲᅳᆷ거니 어즈러이 구ᄂᆞᆫ디고 | 불거니 뿜거니 어지럽게 구는지고
은산을 것거내여 뉵합의 ᄂᆞ리ᄂᆞᆫ ᄃᆞᆺ | 은산을 꺾어 내어 온 세상에 내리는 듯
오월 댱텬의 ᄇᆡᆨ셜은 므ᄉᆞ일고 | 오월 장천에 백설은 무슨 일인가
져근덧 밤이드러 풍낭이 뎡ᄒᆞ거ᄂᆞᆯ | 어느덧 밤이 되어 풍랑이 멈추거늘
부상 지쳑의 명월을 기ᄃᆞ리니 | 부상 가까이서 밝은 달을 기다리니
셔광 쳔댱이 뵈ᄂᆞᆫᄃᆞᆺ 숨ᄂᆞᆫ고야 | 서광 천장이 뵈는 듯 숨는구나
쥬렴을 고텨것고 옥계ᄅᆞᆯ 다시쓸며 | 주렴을 다시 걷고 옥계를 다시 쓸며
계명셩 돗도록 곳초안자 ᄇᆞ라보니 | 계명성 돋도록 꼿꼿이 앉아 바라보니
ᄇᆡᆨ년화 ᄒᆞᆫ가지ᄅᆞᆯ 뉘라셔 보내신고 | 흰 연꽃 한 가지를 누가 보내셨나
일이 됴흔세계 ᄂᆞᆷ대되 다뵈고져 | 이리 좋은 세계 남에게 다 뵈고 싶다
뉴하쥬 ᄀᆞ득부어 ᄃᆞᆯᄃᆞ려 무론말이 | 유하주 가득 부어 달더러 묻는 말이
영웅은 어ᄃᆡ가며 ᄉᆞ션은 긔뉘러니 | 말이 영웅은 어디 가며 네 신선은 그 누구냐
아ᄆᆡ나 맛나보아 녯긔별 뭇쟈ᄒᆞ니 | 아무나 만나 보아 옛 기별 묻자 하니
션산 동ᄒᆡ예 갈길히 머도멀샤 | 선산 동해에 갈 길이 멀고 멀다
숑근을 볘여누어 픗ᄌᆞᆷ을 을픗드니 | 소나무 뿌리를 베고 누워 풋잠을 얼핏 드니
ᄭᅮᆷ애 ᄒᆞᆫ사ᄅᆞᆷ이 날ᄃᆞ려 닐온말이 | 꿈에 한 사람이 날더러 이른 말이
그ᄃᆡᄅᆞᆯ 내모ᄅᆞ랴 샹계예 진션이라 | 그대를 내 모르랴 상계에 진선이라
황뎡경 일ᄌᆞᄅᆞᆯ 엇디그ᄅᆞᆺ 닐거두고 | 황정경 한 글자를 어찌 잘못 읽어서
인간의 내려와셔 우리ᄅᆞᆯ ᄯᆞᆯ오ᄂᆞᆫ다 | 인간 세계에 내려와서 우리를 따르는가
져근덧 가디마오 이술ᄒᆞᆫ잔 머거보오 | 잠깐만 가지 마오 이 술 한 잔 먹어 보오
북두셩 기우려 향ᄒᆡ슈 부어내여 | 북두성 기울여 창해수 부어 내어
저먹고 날머겨놀 서너잔 거후로니 | 저 먹고 날 먹이거늘 서너 잔 기울이니
화풍이 습습ᄒᆞ야 냥ᄋᆡᆨ을 추혀드니 | 화풍이 산들산들하여 양쪽 겨드랑이를 추켜드니
구만리 댱공애 져기면 ᄂᆞᆯ리로다 | 구만리 장공에 잠깐이면 날 것 같다
이술 가져다가 ᄉᆞᄒᆡ예 고로ᄂᆞᆫ화 | 이 술 가져다가 온 세상에 고루 나눠
억만 창ᄉᆡᆼ을 다 ᄎᆔ케 ᄆᆡᆼ근 후의 | 억만 사람들을 다 취하게 만든 후에
그제야 고텨맛나 ᄯᅩᄒᆞᆫ잔 ᄒᆞ쟛고야 | 그제야 다시 만나 또 한잔하자꾸나
말디쟈 학을ᄐᆞ고 구공의 올나가니 | 말 마치자 학을 타고 구공에 올라가니
공듕 옥쇼소ᄅᆡ 어제런가 그제런가 | 공중 옥소 소리 어제던가 그제던가
나도 ᄌᆞᆷ을ᄭᅵ여 바다ᄒᆞᆯ 구버보니 | 나도 잠을 깨어 바다를 굽어보니
기픠ᄅᆞᆯ 모ᄅᆞ거니 ᄀᆞ인들 엇디알리 | 깊이를 모르거니 끝인들 어찌 알리
명월이 천산만낙의 아니비쵠ᄃᆡ 업다 | 밝은 달이 온 세상에 아니 비친 곳 없다
