뎨 가ᄂᆞᆫ 뎌 각시 본 듯도 ᄒᆞᆫ뎌이고 | 저기 가는 저 각시 본 듯도 하구나
텬상 ᄇᆡᆨ옥경을 엇디ᄒᆞ야 니별ᄒᆞ고 | 천상의 수도 백옥경을 어찌하여 이별하고
ᄒᆡ 다 져믄 날의 눌을 보라 가시ᄂᆞᆫ고 | 해 다 저문 날에 누굴 보러 가시는가 
어와 네여이고 내 ᄉᆞ셜 드러 보오 | 어와 너로구나 내 이야기 들어보소
내 얼굴 이 거동님 괴얌 즉ᄒᆞᆫ가마ᄂᆞᆫ | 내 얼굴, 이 거동이 임에게 사랑받을만 하건마는
엇딘디 날 보시고 네로다 녀기실ᄉᆡ | 어딘지 날 보시고 너로구나 하고 여기시기에
나도 님을 미더 군ᄠᅥ디 전혀 업서 | 나도 임을 믿어 다른 뜻이 전혀 없어
이ᄅᆡ야 교ᄐᆡ야 어ᄌᆞ러이 구돗ᄯᅥᆫ디 | 응석과 교태를 부리며 어지럽게 굴었던지
반기시ᄂᆞᆫ ᄂᆞᆺ비치 녜와 엇디 다ᄅᆞ신고 | 반기시는 낯빛이 옛날과 어찌 다르신가
누어 ᄉᆡᆼ각ᄒᆞ고 니러 안자 혜여ᄒᆞ니 | 누워 생각하고 일어나 앉아 헤아려보니
내 몸의 지은 죄 뫼ᄀᆞ티 ᄡᅡ혀시니 | 내 몸이 지은 죄가 산같이 쌓였으니
하ᄂᆞᆯ히라 원망ᄒᆞ고 사ᄅᆞᆷ이라 허믈ᄒᆞ랴 | 하늘을 원망하고 사람을 꾸짖으랴
셜워 플텨 혜니 조믈의 타시로다 | 서러워 풀어 헤아려보니 조물주의 탓이로다
글란 ᄉᆡᆼ각 마오 ᄆᆡ친 일이 이셔이다 | 그런 생각 마오 맺힌 일이 있소이다
님을 뫼셔 이셔 님의 일을 내 알거니 | 임을 모시고 있어 임의 일을 내 알거니
믈 ᄀᆞᄐᆞᆫ 얼굴이 편ᄒᆞ실 적 몃 날일고 | 물같던 얼굴이 편하실 적 몇날일까
츈한고열은 엇디ᄒᆞ야 디내시며 | 봄 추위와 여름 더위는 어찌하며 지내시며
츄일동텬은 뉘라셔 뫼셧ᄂᆞᆫ고 | 가을날과 겨울에는 누가 모셨는가
쥭조반 죠셕 뫼 녜와 ᄀᆞᆺ티 셰시ᄂᆞᆫ고 | 죽 조반과 아침 저녁 진지는 옛날과 같이 잘 잡수시는가
기나긴 밤의 ᄌᆞᆷ은 엇디 자시ᄂᆞᆫ고 | 기나긴 밤에 잠은 어찌 자시는가
님다히 쇼식을 아므려나 아쟈  ᄒᆞ니 | 임 향한 소식을 어떻게든 알고자 하니
오ᄂᆞᆯ도 거의로다 ᄂᆡ일이나 사ᄅᆞᆷ 올가 | 오늘도 거의 지나갔구나 내일이나 사람 올까
내 ᄆᆞᄋᆞᆷ 둘 ᄃᆡ 업다 어드러로 가쟛 말고 | 내 마음 둘 데 없다, 어디로 가자는 말인가
잡거니 밀거니 놉픈 뫼ᄒᆡ 올라가니 | 잡거니 밀거니 하며 높은 산에 올라가니
구롬은 ᄏᆞ니와 안개ᄂᆞᆫ 므ᄉᆞ 일고 | 구름은 커녕 안개는 무슨 일인가
산쳔이 어둡거니 일월을 엇디 보며 | 산천이 어두운데 해와 달은 어찌 보며
지쳑을 모ᄅᆞ거든 쳔 리ᄅᆞᆯ ᄇᆞ라보랴. | 가까이를 모르거든 천 리는 어찌 보랴
ᄎᆞᆯ하리 믈ᄀᆞ의 가 ᄇᆡ 길히나 보쟈  ᄒᆞ니 | 차라리 물가에 가서 뱃길이나 보고자 하니
ᄇᆞ람이야 믈결이야 어둥졍 된뎌이고 | 바람이야 물결로 어리둥절하게 되었구나
샤공은 어ᄃᆡ 가고 븬 ᄇᆡ만 걸렷ᄂᆞ니 | 사공은 어디 가고 빈 배만 걸려있구나
강텬의 혼쟈 셔셔 디ᄂᆞᆫ ᄒᆡᄅᆞᆯ 구버보니 | 강가에 홀로 서서 지는 해를 굽어 보니
남다히 쇼식이 더옥 아득ᄒᆞᆫ뎌이고 | 임 향한 소식이 더욱 아득하구나
모쳠 ᄎᆞᆫ 자리의 밤듕만 도라드니 | 초가집 찬 자리로 밤중에 돌아오니
반벽청등은 눌 위ᄒᆞ야 ᄇᆞᆯ갓ᄂᆞᆫ고 | 벽 가운데 걸린 푸른 등불은 누굴 위하여 밝아 있는가
오르며 ᄂᆞ리며 헤ᄯᅳ며 바니니 | 오느락 내리락 헤매며 왔다갔다 하니
져근덧 녁진ᄒᆞ야 풋잠을 잠간드니 | 잠시 힘을 다해 풋잠을 잠깐 드니
졍셩이 지극ᄒᆞ야 ᄭᅮᆷ의 님을 보니 | 정성이 지극하여 꿈에서 임을 보니
옥 ᄀᆞᄐᆞᆫ 얼굴이 반이나마 늘거셰라 | 옥 같은 얼굴이 반이나마 늙었어라
ᄆᆞᄋᆞᆷ의 머근 말ᄉᆞᆷ 슬ᄏᆞ장 ᄉᆞᆲ쟈 ᄒᆞ니 | 마음 먹은 말을 실컷 아뢸까 하니
눈믈이 바라 나니 말인들어 이ᄒᆞ며 | 눈물이 바로 나니 말인들 어찌 하며
졍을 못다 ᄒᆞ야 목이조차 몌여ᄒᆞ니 | 정을 못 다하여 목조차 메려 하니
오뎐된 계셩의 ᄌᆞᆷ은 엇디 ᄭᆡ돗던고 | 방정스런 닭 소리에 잠은 어찌 깨었던가
어와 허ᄉᆞ로다 이 님이 어ᄃᆡ 간고 | 어와 허사로다, 임이 어디 간 것인가
결의 니러 안자 창을 열고 ᄇᆞ라보니 | 잠결에 일어나 앉아 창을 열고 바라보니
어엿븐 그림재 날 조ᄎᆞᆯ ᄲᅮᆫ이로다. | 어여쁜 그림자 날 쫓을 뿐이로다
ᄎᆞᆯ하리 싀여디여 낙월이나 되야이셔 | 차라리 물 새듯 사라져 지는 달이나 되어서
님 겨신 창 안ᄒᆡ 번드시 비최리라 | 임 계신 창 안을 환히 비추리라
각시님 ᄃᆞᆯ이야ᄏᆞ니와 구ᄌᆞᆫ 비나 되쇼셔 | 각시님 달은 커녕 궂은 비나 되소서
된뎌이고 | 되어구나
강텬 | 강가
모쳠 | 초가집 처마
반벽쳥등 | 등불
헤ᄯᅳ며 | 해뜨며
바자니니 | 부질없이
슬ᄏᆞ장 | 실컷
ᄉᆞᆲ쟈 | 사뢰려
바라 | 바로
오뎐된 | 방정맞은
결의 | 꿈결에
싀여디여 | 사라져
싀여디여 | 죽어서
